市辖区	葫芦岛市
连山区	葫芦岛市
龙港区	葫芦岛市
南票区	葫芦岛市
绥中县	葫芦岛市
建昌县	葫芦岛市
兴城市	葫芦岛市
市辖区	朝阳市
双塔区	朝阳市
龙城区	朝阳市
朝阳县	朝阳市
建平县	朝阳市
喀喇沁左翼蒙古族自治县	朝阳市
北票市	朝阳市
凌源市	朝阳市
市辖区	铁岭市
银州区	铁岭市
清河区	铁岭市
铁岭县	铁岭市
西丰县	铁岭市
昌图县	铁岭市
调兵山市	铁岭市
开原市	铁岭市
市辖区	盘锦市
双台子区	盘锦市
兴隆台区	盘锦市
大洼县	盘锦市
盘山县	盘锦市
市辖区	辽阳市
白塔区	辽阳市
文圣区	辽阳市
宏伟区	辽阳市
弓长岭区	辽阳市
太子河区	辽阳市
辽阳县	辽阳市
灯塔市	辽阳市
市辖区	阜新市
海州区	阜新市
新邱区	阜新市
太平区	阜新市
清河门区	阜新市
细河区	阜新市
阜新蒙古族自治县	阜新市
彰武县	阜新市
市辖区	营口市
站前区	营口市
西市区	营口市
鲅鱼圈区	营口市
老边区	营口市
盖州市	营口市
大石桥市	营口市
市辖区	锦州市
古塔区	锦州市
凌河区	锦州市
太和区	锦州市
黑山县	锦州市
义　县	锦州市
凌海市	锦州市
北宁市	锦州市
市辖区	丹东市
元宝区	丹东市
振兴区	丹东市
振安区	丹东市
宽甸满族自治县	丹东市
东港市	丹东市
凤城市	丹东市
市辖区	本溪市
平山区	本溪市
溪湖区	本溪市
明山区	本溪市
南芬区	本溪市
本溪满族自治县	本溪市
桓仁满族自治县	本溪市
市辖区	抚顺市
新抚区	抚顺市
东洲区	抚顺市
望花区	抚顺市
顺城区	抚顺市
抚顺县	抚顺市
新宾满族自治县	抚顺市
清原满族自治县	抚顺市
市辖区	鞍山市
铁东区	鞍山市
铁西区	鞍山市
立山区	鞍山市
千山区	鞍山市
台安县	鞍山市
岫岩满族自治县	鞍山市
海城市	鞍山市
市辖区	大连市
中山区	大连市
西岗区	大连市
沙河口区	大连市
甘井子区	大连市
旅顺口区	大连市
金州区	大连市
长海县	大连市
瓦房店市	大连市
普兰店市	大连市
庄河市	大连市
市辖区	沈阳市
和平区	沈阳市
沈河区	沈阳市
大东区	沈阳市
皇姑区	沈阳市
铁西区	沈阳市
苏家屯区	沈阳市
东陵区	沈阳市
新城子区	沈阳市
于洪区	沈阳市
辽中县	沈阳市
康平县	沈阳市
法库县	沈阳市
新民市	沈阳市
三河市	三河市
秦皇岛市	秦皇岛市